23 33
#################################
##########   e         @  #######
#######    ##############   #####
######  ################### #####
###### ###########             ##
###### ##########  ***********  #
###### ########## ************* #
##     ##########  ************ #
#  ### ###########              #
# #### #######################  #
# #### ######################## #
# #### ######################## #
# #### ######################## #
# #### ######################## #
# #### ######################## #
# #### ######################## #
#  ### #######################  #
##     #########     ######### ##
###### ######### ### ######### ##
###### ######### ### ######### ##
######  #######  ###  #######  ##
#######         #####         ###
#################################
